node_name	node_type	
DB00831	drug	
ADRA1A	drug_target	
CALY	drug_target	
CYP1A2	drug_target	
DRD2	drug_target	
XDH	drug_target	
ABCB1	drug_target	
TNNC1	drug_target	
UGT1A4	drug_target	
S100A4	drug_target	
Dyskinesia, Drug-Induced	phenotype	
Gastroparesis	phenotype	
Chronic schizophrenia	phenotype	
Opiate Addiction	phenotype	
Polydipsia	phenotype	
Nausea	phenotype	
Cocaine Dependence	phenotype	
Pharyngeal Neoplasms	phenotype	
Heroin Dependence	phenotype	
