node_name	node_type	
DB01072	drug	
CYP2C9	drug_target	
CYP2C8	drug_target	
ALB	drug_target	
ABCB1	drug_target	
UGT1A1	drug_target	
SLCO1B1	drug_target	
SLCO1B3	drug_target	
ABCB11	drug_target	
CYP3A4	drug_target	
ABCC1	drug_target	
Hyperbilirubinemia	phenotype	
Drug Allergy	phenotype	
Hepatitis D Infection	phenotype	
Febrile Neutropenia	phenotype	
Neutropenia	phenotype	
Adverse drug events and drug allergies	phenotype	
Leukopenia	phenotype	
Cholelithiasis	phenotype	
Peptic ulcer	phenotype	
